duim	kennen
kies	krijgen
wol	kruipen
voetlicht	komen
honderd	lopen
korrel	nemen
sleeptouw	nemen
vuist	gaan
pet	houden
water	halen
achtergrond	blijven
hand	doen
duim	draaien
zwaard	grijpen
woord	houden
weg	helpen
borst	kloppen
oor	knopen
kast	komen
dag	leven
hoofd	leren
bed	lichten
geranium	zitten
val	lopen
arm	nemen
stroom	roeien
dak	schreeuwen
kaart	spelen
ves	spuwen
hemd	staan
eer	strijken
hoed	toveren
bel	trekken
jas	trekken
gat	vallen
rol	vallen
windmolen	vechten
zadel	wippen
roos	zitten
straat	zetten
vuur	spelen
kraag	vatten
ziel	trappen
handschoen	trouwen
knie	krijgen
wijs	brengen
broek	doen
vinger	hebben
deur	houden
hand	houden
achterhoofd	houden
lat	staan
bocht	gaan
aarde	vertrouwen
voet	maken
lappenmand	zitten
